NO ./images/walls/wall3.xpm42
SO ./images/walls/wall2.xpm42
EA ./images/walls/wall1.xpm42
WE ./images/walls/wall4.xpm42

F 155,155,255
C 225,255,255

        1111111111111111111111111        1111111111111111111111111
        1000000000110000000000001        100000001100000100000011
1       1D11000001110000000000001        1000000001110000010000001
        100100000D000000000000001        1000000000000000000011111
111111111011000001010000010000001111111111D11000111D100000100D001111111111
1000000000000000000000000000000000000000000000000000000000E000000000000DX1 
1111D111111111111100000000001111101111010110110000000100011111222222222221
1111D0111111111011111D1110000111110111111111011001010D00001111111111111111
11000000110101011110000010000D0000000110101011110000010001
100000001000000011000000D00111100000001000000010000001000111
10000000000000001101010010001100000000D0000001101010010001
1100000111D1010111111111100111000001110101111111011110011
11111111 101000000000001111111111111 1011111000000011011
1111111111D11111111111D11           11011111111111111D1111111
1000000000000000000000001          1000000000110000010000001
1011000001110000000000001         1011000001110000010000001
10010000000000000000000011111111   1001000D0000000000000001111111
111111111011000001010000D000000011111111110111000010100000D0000001
1000000000110000011111011111111111000000000110000011111D1111111111
11110111111111111100000010001111100111111111011100000010001
1111D11111111101110101000000111110111111111011101010000001
111D0000110101D1111000D01000111000000110101011110000010001
1300100010000000110000100000D000000001000000011000001000111
12001000D00000001101D1001000110000000000000001101010010001
1132111111D101011111011110011100000111D101011111011110011
11111111 101111111111111111111111111 1011111111111111111
          1                           1
