
F 0,0,255
C 0,255,255

NO ./images/walls/wall3.xpm42
SO ./images/walls/wall2.xpm42
EA ./images/walls/wall1.xpm42
WE ./images/walls/wall4.xpm42

11111111111
11110001111111111
100D0W0000D0000X1
11110000001111111
11 10001111
   1D1111
   100001
   111111
