
F 0,0,255
C 0,255,255

NO ./images/walls/wall3.xpm42
SO ./images/walls/stone.xpm42
EA ./images/walls/wall1.xpm42
WE ./images/walls/wall4.xpm42

1 111111 1111
1 111000 111111111 1
1 00D0W0 000D0000X 1
1 111000 000111111 1
1 1 1000 1111
   1D111 1
   10000 1
   11111 1
