NO ./path_to_the_north_texture
SO ./path_to_the_south_texture
EA ./path_to_the_east_texture
WE ./path_to_the_west_texture

F 0,255,0
C 0,gdfgdf,255

11111111
10100001
10100001
10000001
1000W001
10000101
10000001
11111111
