NO ./path_to_the_north_texture
SO ./path_to_the_south_texture
EA ./path_to_the_east_texture
WE ./path_to_the_west_texture

F 220,100,0
C 225,30,0

11111111
10100001
10100001
10100001
1000S001
10000101
10000001
11111111
