NO 
SO 
./images/walls/bricks.xpm42
WE ./images/walls/gold.xpm42
EA ./images/walls/wood.xpm42

F 220,111,119
C 225,111,200

 11111111111111111111111111111111111111
1000000000000000000000000000000000000001
1000000000000000000000000000000000000001
1000000000000000000000000000000000000001
1000000000000000000000000000000000000001
1000000000000000001010000000000000000001
1000000000000000001010000000000000000001
1000000000000000001N10010000000000000001
1000000000000000001110010000000000000001
1000000000000000000000000000000000000001
1000000000000000000000000000000000000001
1000000000000000000000000000000000000001
1000000000000000000000000000001110000001
1000000000000000000000000000001   100111
 11111111111111111111111111111111111111   