111111111
100N00001
10000S001
1000000E1
1W0000001
111111111
