    111
111100011111111111111111
100000000000000000000001
100000000011111111111001
11110001111         1001
    111             1111
