    111
11110001111
10000000001
1111000W001
11 10001111
   101111
   100001
   111111
