    111
11110001111
10000000001
11110000001
11 10001111
    101
   100001
   111111
