    111
1111N001111
10000000001
11110000001
11 10001111
   101111
   100001
   111111
