1111111111111111111111111111111111111111111111111111111111111111111111111111111111111111111111111111
1000001000010000000000010000000010000000000000110010010000010101110001010000110101010000000001011001
1001000000000000100100000010000000010100001101101000000010010000010100001000000100000000100001000001
1010000010100000000000000000000000110000010010000100000000001100010000101000000100001101001000000001
1000000101000000100000010001001010010000100000111000000101011100000001000000010000101000001000010101
100000N100100100010000010000000101000000000001000000100000000000110000100000001000010010001000001001
1100000000110000000010100001100000001100100100000000111001000010000101001000000001100000000000010001
1100000000000000101001000010000000100000101000000000010010100000110000000000000010100010000100000001
1000000000100001000000000000011000010000010000100000000100100011000000100000000100110000000010000001
1010000000000001000100000000101000010000010000000000010000000000010100100001000001100000010000000001
1000000001101000000001000001010110101000101001000000001001100100001000010010101000100010000000011011
1110000100000000000011000010100000100000001000010000010000000000010100010000111100100010000000000001
1000010000000100000000000000010100110000000000100000000100000001000100000100000010000110100000001101
1011000000100001000000000100000100000000000000110111000100000010000100101100000000100110000000000011
1010001000010000111000000000000000100000101000100000011000100100000000100111000001000001000001000101
1000000100000000100010001001000001000000100100000101000000010000000000000000000000000100000101010001
1010000000000000110000000000100000000000000000011000000000000000000000001000100000100101000000000001
1000000000000001100101100000100001000000000000000000000010011000101000010001110101001101010010000101
1001001001010000001000100100001000000010000001001000110100000110000000000000000000100000001000000011
1000000000000110100101110001000000010000000101100010100100000000010010000000000000000000000000001001
1000001010000100000000000000000000000011001000111000010000100000000001000000000010010000001000001001
1000000000000000010010100001000001000000000001000010000100000000000000010010001000000100011000000001
1000000000010010000110000000010000010000100001100000010000000010000000000010000010000001000001000101
1000010001000100000100000000000000011100010001010001000000000011000000000000000010000100001000010011
1001000000010100010101010010001001000100100000100000000000100010000000000000110100000010110100010101
1010000000000010011100000000010000000000000000100001010001000100000000000000000000100000001000110001
1011000000100000000001000010000000000000000000001000010010001000000000000100000011000000001000100001
1101000000001000010000100010010001100010000100001000001100000000000100111000000001011000010110000001
1010000001000000010000000100010000000110010001000100000000010000000000000000000101010000000101000001
1100000000000000000100000001001000000001010000000000001001100000011000010100000001000001000000000001
1000000001000100000000001000000010000000010000010000010000001010100011010010001000110000011001000001
1111000000011000000100010000100011100110001001000000000001110000100001000000011001000100100010000011
1110000000100000001001000000000000000000100000100000000010001000000000100000001000000000000000001001
1000000000000000101000000011000000000000001000011000111100010001100001100001000100000011000000000001
1000000000001010000000010101000000100011000000000001100000000000000000000000000011110000001000000111
1001100100000101000011101010001010100000000000010000000000000110010110100000000100011000001010000001
1001100000110010100000000000001000000011001000000000001000100000100010011000000100000001000001000101
1000011100000000100000000011000000100001000101000010100000010000100001100001000000000010101110100011
1010000010000100010001110100000000001000000011000001100000000000000110000001000000100010001000000001
1000001000001100100000100000100101001000000000000000001001010000100000000000100000000000100000001011
1100000100010001100001001001011000000000000001000001101000000000010000000010000000100000000001000001
1000000000000000000100001001010100000000000000000001000000000000000000000110000001000000001000000101
1000110000000000010001100000100100000011000011001010000000000100010000000000010000110000110010010001
1010000000001000000000000001000010000010000001000001000111000000001000001010000000000000110001100001
1000000000000001101000000110100100011100101100000011001000100001110001000001000000000010000000000101
1010000100100000010010011000000001000111001011010000100000000000000000000000101000100000100001000001
1010000001011000010001000000000000010000000110100000000101000010011111000100101100010000100010000011
1000001000000010100000000000001000100110000000000000000010000000001110000000010000000001000000000001
1010000000001000000000000001000010001000000010001000100000100010000000001010010010010010100101000001
1000000000000001000101000010000001000000010000100000000011010000000000000001101000000100000000000001
1000000000000000001110010000001000110000011001000000000000000000000100010000010100000010010000000001
1011000000100000001100000000000000000100000000010010000000101001000010011000001000000000010100000011
1100000000101010100000010001000000010100000111001000000010000010000001010000111000000000000000000001
1011000101000010011000000000000000000000000001001000100100000010010000000000010100100100111101000001
1000010001000000000000000010000010000011001011000000000001000000000000011001001010001100000000100011
1100011000100001000000100001010000000000000010000000110000000100000000010011010000000000001001000001
1000010001101100010001011010000000000100100010000001110000000001110101100000100010000110001100100001
1000000011001000000000000000100010000001000100000001000000000000000010001100000000000011100000001001
1000000000001000000000001000100000000001000000000000000001010000000000000110100000101000000100010101
1110010010011000000000000010000000100000011001000110000000000100000000000010001100000000001001010001
1000000010000000000011000000000010111100000001000110001000000000000000111000110001100010000100100101
1100011010001100010000000001000000000000101001010110100000010000000000000001000010101000000000000011
1001000000110001001100100000000000000000100001110000000000000000010001001000000001100100000000010001
1000000000010000000001000000100000011000000001000000000000000010000010100101000100010000001000000101
1010101010101010100000000000000000110110000011000001000001000000000000000010000000111011000110100001
1100000000001010100000000001000000010000000000000110000000010000000000000001011000001000100001000001
1011001000010000000000010001000000101000010000100001000001000100010001000000001000010100000000010001
1111000100000000011010000001001010000101000000000000101000001010000100000000000000100011000000000001
1001000000000001000101000000100000000000000000000000000000000000000000000000010000000000000101000001
1101000000101001000010011000110100011000000001000100100000001000001100000000001011010100000010000001
1000100000001001000011011000000100000001001010000011000000001010000100000000000100001111000010001001
1000010000000010000000000010100000000000001010010000000000001011001000000000100100100100000010000101
1000010000010010010010000000010000001000001000000001000000000000100100100010010010000010011000000001
1001000000000000000000000000000000000101010100001011000001000110000000000010001000001010000010000001
1100001000000100000010000000000000010000100000000011000101001000110000000001000100100001000100000011
1010001000000000000000000000000010101011000000000001000010000101010000100000000000010000010100000001
1010000101000011101000001000010000000000000010100000000000011000110010001100000010000011110000000001
1000001010010100000000001100010000000000100100100000100000001000000000101000010000000000000011000001
1000000001000000000000101010000000010100000000000001100000100001100000010110000110100000000001011001
1000000010001000100001010000000010000001011000100001000110100000001000001000000000110000101000010001
1001000000010000010000000100000000000000110000001000000000010101000010100000110000100110000001000001
1100111000000000010001100000001000000000010000100001000100111000010000000000000001000100100000000001
1010000000000000000000000000000001000100010010000100100000010000000100000000001101000000010000000001
1000000000010100011001110000000000010000000010000000101100000100010010000000000000000111100000000001
1100000110000000000001000000000000000100010010000000001001000011000001000000001000001000000010000001
1001001110000000001010000010000100000101000000000001011000000000000000010010110000000000000000100101
1000100000100000000000000110010001000000110010110001000000110000000000110010000000000000001000000001
1000001000000000010000001000000000000000100000001100010100000000011100000000000000000000000010000001
1000000000100000010000000000000000000000000110000001000101000000000011010100001010000000000000001101
1100000000000001000110011000000000000000100100011000000101000000000010001000100001000000100101000001
1000010000010011000011000000000110011100000010000000001000000100001010100001100000011000000000000001
1000000000000101000000010100000000000001100010110000100010011000100000000000010010000000000000001011
1000011001010100000100100101000100000000000000000011001010001001001100000000000001001000000000000011
1110000100000000000100100000000000000000010100110000100010000000000001010001100000010000011000100001
1000010000001000010000000100100000001010000000000010000000000110000000010000100000000000000000100001
1010010110000010001000000000000001000000000001000100000000000000000001001001000000000000000000001001
1100000000100000000011100100000010001100000000000100000000100111000010000010010000000010001000011001
1100110010000000000001001100100010000001010000010000001010011001011000000010000000000000000010010011
1000110100000011010010000110000000000100000000000100001000011000000010000000010000000010001000010001
1111111111111111111111111111111111111111111111111111111111111111111111111111111111111111111111111111
