NO ./images/ready/wall3.xpm42
SO ./images/ready/wall2.xpm42
EA ./images/ready/wall1.xpm42
WE ./images/ready/wall4.xpm42

F 125,125,125
C 0,150,255

1111111111111111111111111111111111111111111111111111111111111111111111111111111111111111111111111111
1010100000111001100010010100000000000001000100001100000110001010001000011000100010000010000110000011
1001000000010000001000011001010100001100101100100010001000000100100100010000000010010101000000000001
1100000000000000001000010100000100000010011100010000010000100100000011001101000100000001001000010011
1000001000000000100000000000010000100000000100010000100100000001010000001001000010000000100100101101
1000010001100001000000000000000111000100000100000000010000000000001000000000001000011100000100000101
1000000000000100111010000000000000011000000000001000000000010000010000000010000000001010000000000101
1000000000100011000100000101010010101000000001001100000100110001100100100100000001001010000000000001
1010000000100000000000001010000110000010001001100000110000100110001010000000100010100001001001000011
1000000000100101000011001000000110000000000000010010101010001000000010000000000000100000001000001001
1000000011010001100101100000000000001100101010101000110000010010101100010000000001001101010100101101
1000000000000000100000111000000010101000100110000110000000010010000000100100010000000100000000000001
1100101100000100010010100000000111001000110010010000011010100000000101011001000010100100010010010001
1000010010001100010010000001000000100000010000000110101000100000000011010000001000000000010000010001
1000000101000001001110000000001000000000100000000000011000000000100000110000001100000011001000001001
1000100000010000000101000000000000000100001110000100000000000001010000000000010110000000010100010101
1010010000010000100000110000010010010000000101100111100000010000000011010010000000100000000010000001
1100000000000000000101000010000000000000010011000110000000010100001000101000010000000001000000011101
1000000000001000000000000000110010001000100000000001000010000000000000011010010001001101100000000011
1001000100000000010000110000010000000000010000000000100001000000001010010001010000011100000000000001
1111000000010010010000000000100000011000100001100000W00100100001011000010000000110000000001010000001
1001000010000000000100010000100000010010010100000000000001000000000000100000000000000001001000001001
1001011000000000000000001000101000001100101010001000000000001000010011000001000000000100000010100011
1001000001110000100000000100000100010101001000000000000100011000000000100001111100000001000000010011
1000101000110000100100000100100000100000000000010100000000001010000000000000000001000100000000010001
1000000100000000010000100001001000000010011001001001100000010000000110011000101100001100000000001001
1110000000000001000001011000010000000000000001000100010000010000100000000000010100000001000000000011
1000010001000001001101001100000000000000011000000100010000100100000000000010010000001000010100000001
1100000010010101000100010000000000000000010001000000000000000001000000000010000100011000000000000001
1000010000001100000100000000100000000000000100001000000000000010000010000000001010000000000101000001
1001100000010001000000000000000000100000000000000000100000000000001000000000000000000101000000101001
1100001101000000100100000100000000000000000100011100000100000000000100000000001000000010000000000011
1100000010100011000000000001000000000000000000000000101100001000000110000000011000001010101100000111
1000000100100011000101000010100000000001010000000100001001010101000000000000000000001000100000001001
1010000001000000100000010010000000100000010100100010010011000000001100100011100010000011110110000001
1100011000001010001000101011001010100000010011100011010000000000000010010000000001000000000000001011
1001001010000100001000100000000100000001100000000010011000000110101001000000100000000000000001000001
1000010100000000000001000000000010000001000001000000000000010000000010010000011101100000000011001001
1000010000001001000101100000000100011000000001110100100001000010010100001000010110001110000001000001
1001000000011001100000101010010000000000001110000000000000001000101101000000001000000000000000000001
1100100000000000000100010000000001000000001000010100000000010100010110000001000100010000001011000011
1000000000010101010010010000000100000100111101101000000001011000101010001100010000000000000000010101
1001010010010110100000001011001001100110000001001100000001000000101000100100001000100000000110010101
1000000000000010110000001001010101000000001000001000010000001010100010000101000000100100101000001101
1010001000000000011100000000000000000010000100000000000100000100000000001100110000000100100000100101
1100010101001000000001000000000100000000000000001000110000000000100000000011111010000011100000110011
1000000000010001100011000100101000000000100010000001000000010000000000100101000011000000000111001001
1010001001000001000000000000000101000000100100000000010000110100110010000000000001000000010010001001
1101010010000010000000100000100000000000000000010010000000100000110000000110010001000010001100111001
1010000000100011000000000010100110001010000000000000000010001010011000001001010000001001000000001001
1010000000000010000000000000001101110100001000000001000100100000000100000000110010000000100000100001
1000010001101000111000000001001000100011011100000000010001001010000000000000000001000000000000001101
1000000001000111000001100100000000000000000000000000100000000100010000001000001111100001000010100101
1000001001000001011000000000000001000000000000000000100001010000100100001000000100100000000001011001
1100000000010000000000000000111001001110100000000000000011000000000000000001000100000100000010001001
1000000000000000000100000001001000100000000000000000001000010111000000001000000000001010000001000011
1000000000001100000001000000000001100000100010001000000000111001000100100000000000000000010000011001
1000000011000100000000010100000100000000001000100000000000010101001010001101000011000000000000000011
1000001000110100000010100010000000000001000000000110010000000000001000000000000000010001000000000001
1000011000011000001110010000101000000000010000000100010100010101001000100000100100001000010000000011
1000000010010000000110100000000000000000100000010000100001101010000000010000000010100010000001000001
1000000001000010011000010000000001000000000010101000000100000000101001000010000011100000000100000001
1000100000000000001001001000000110000000000001000000000001100000000100001010000000110000010000000001
1010000010010100001001000000001000000001000000000001000000000010000101010000000100011100000101100001
1100010000010000101000100101010100100001000000010000000000000001100000000010000010000000000001001001
1100000100000000010100000011001000100000001000000000010100000000010100000000001000011000001001110001
1100010100000000000000000000000010100000010010000000000000000000000001000000000000010000110000010001
1010000100000000011110000000001000000110000001001110100000000010010001000011000000011001000000001001
1010000001001001001100000000000000000001000001101010001000000001011110010000000001000111000001010001
1000010000000000000011000000000000001000100101000000000000001001001000000000010100100100010100010001
1000000010000000000000000100001000000000010100000000100000110000000000001001001000000000000001010001
1110010110101000000000000000111000010000000100100000000001001011110010011000000100100001000101000001
1001000000000010100000000010000010001100100000110001000100110000100010000001000000000000010000000111
1000000000010000000110000000101001000001100010010001001000000010000100100000000010001000001100000001
1000000100100000011000000000000000000001000011000000101000000001001000100010000100001000001000111001
1100000010000000101100001001000000000000000100000000000000000000000001000000000101000101100000000001
1000000001100000010101001100100000100011011100000100010000001010000000010010000001000110000100100001
1000001011001001000010101000000010100010000000000000000000110000000101100000001000000101000010100011
1001000000100000011000000100000100000100010000000000000000011101100000000001000000100100001000000001
1000000000010100001000000010000000010111010100000010010000001110000000001000001000000000000000000001
1000000000000000001001000011000110110001100000000110001000000100010110000100000010010000000100000101
1000010000100001100000110101000000001000000011110000011010000000001001000100000001011010000000010101
1000100000000000000000000000000110000100000010010100000000001010000000010000000000011001110000101001
1000001000000101000000010000000010000001010001000000001001000001000110001000000010000000000001000111
1100010100000001101010001001100000001010000110101000001110000100001000110000100100000010000000000011
1000100000000000010100010100010010100101000110000000001000100000011000000010000000001000001001000001
1000000000000110100001000100000010000001000000000000101011000000110000000100011010001110010010000001
1000010000100010000000000100010000000000110000000010100000010000010000000010010001000000000011100001
1000000000001100000000000000000010011001000011000010111000001011100000100000010101000101000000000001
1100000000000010000000000000000000010000000110001000000101000000101001111000101000000010000100010001
1010010001000001011011000000100010000110000000000001000000000100100101000000000010010000001000000001
1110000000001110010100010011001000000000000010000111011101000000010000100000000010000001000000000101
1010000000001000000000000010000001111001011001000100001011011000010000000001000001000000101101000011
1100000000011000000000010100000001100000000001100100000000101000011000101001000001011000000011100011
1001010100000000001010001000000000000101001000000100100000001000000001010010000000000000110000000001
1000000001010100000110100100001000000010000010101110000010001000000000100010001111000100001000001001
1000000110000000000000010010010100000000000100101100000110110000000100001000010000010010000000000011
1010000100000110011001100010000100000010000000000001010001100000001000001000100000011001001100000001
1000000110010011000000000010000010000000001000001111000000101000000000000010000000010100000010010101
1111111111111111111111111111111111111111111111111111111111111111111111111111111111111111111111111111
