    111
11010001111
10001000001
10000000001
11110001111
    111
