    111
11010001111
10000000001
10000000001
11110001111
    111
